pokabilities	Format pokabilities using literal string %[metadatapokabilities]
pokabilitiessmall	Format pokabilitiessmall using literal string %[metadatapokabilitiessmall]
pokft	Format pokft using literal string %[metadatapokft]
pokgeneration	Format pokgeneration using literal string %[metadatapokgeneration]
pokheight	Format pokheight using literal string %[metadatapokheight]
pokimage	Format pokimage using literal string %[metadatapokimage]
pokjapanese	Format pokjapanese using literal string %[metadatapokjapanese]
poklbs	Format poklbs using literal string %[metadatapoklbs]
pokname	Format pokname using literal string %[metadatapokname]
poknational	Format poknational using literal string %[metadatapoknational]
poknumber	Format poknumber using literal string %[metadatapoknumber]
pokspecies	Format pokspecies using literal string %[metadatapokspecies]
pokstats1	Format pokstats1 using literal string %[metadatapokestats1]
pokstats2	Format pokstats2 using literal string %[metadatapokestats2]
pokstats3	Format pokstats3 using literal string %[metadatapokestats3]
pokstats4	Format pokstats4 using literal string %[metadatapokestats4]
pokstats5	Format pokstats5 using literal string %[metadatapokestats5]
pokstats6	Format pokstats6 using literal string %[metadatapokestats6]
poktype	Format poktype using literal string %[metadatapoktype]
pokweight	Format pokweight using literal string %[metadatapokweight]
